11111111111111111111111111111111
10000000000000000000000000000001
10000000000000000001111111000001
10000000000000000000000000000001
10001111000000000001111111000001
10001111000000000000000000000001
10001111000000000001111111000001
10001111000000000000000000000001
10000000000000000001111111000001
10000000000000000000000000000001
10000000000000000001111111000001
10000000000000000000000000000001
10000000000000000001111111000001
10000000000000000000000000000001
10000000000000000001111111000001
10000000000000000000000000000001
10000000000000000001111111000001
10000000000000000000000000000001
10000000000000000001010101010101
10000000000000000000000000010101
10000000000000000001010101010101
10000000000000000000000000010101
10000000000000000001010101010101
10000000000000000000000000010101
10000000000000000001010101010101
10000001000000000000000000000001
10000001000000000000000000000001
10000111110000000000000000000001
10000001000000000000000000000001
10000001000000000000000000000001
10000000000000000000000000000001
11111111111111111111111111111111