1111111
1000001
1011001
1000101
1000101
1001001
1010001
1111111